#,#,#,#,#,#,#,#,#,#,#,#,#,#,#,#
#,.,.,.,.,.,.,.,.,#,#,#,#,#,#,#
#,.,P,.,.,.,.,.,.,.,.,.,.,.,G,#
#,.,.,.,.,.,.,.,.,#,#,#,#,#,#,#
#,.,.,.,.,.,.,.,.,#,.,.,.,.,.,#
#,#,.,.,.,.,.,.,.,#,.,.,L,.,.,#
#,#,#,.,L,.,.,.,.,#,.,.,.,.,.,#
#,.,.,.,.,.,.,.,.,#,.,.,.,.,.,#
#,.,.,.,.,.,.,.,.,#,.,.,.,.,.,#
#,#,#,#,#,#,#,#,#,#,#,#,#,#,#,#
