#,#,#,#,#,#,#,#,#,#,#,#,#,#,#,#
#,L,.,.,#,.,.,.,.,.,.,.,.,G,.,#
#,L,.,.,#,#,.,.,S,.,.,.,.,.,.,#
#,L,.,.,.,.,.,.,H,.,.,.,#,#,#,#
#,L,.,.,#,#,.,.,.,.,S,.,.,H,.,#
#,L,.,.,#,.,.,.,.,.,.,.,#,#,H,#
#,L,.,.,#,.,S,.,.,.,.,.,.,#,.,#
#,L,.,.,#,.,.,.,.,.,.,.,.,#,.,#
#,L,.,.,#,.,P,.,.,.,.,.,.,#,.,#
#,L,.,.,#,.,.,.,.,.,.,.,.,#,L,#
#,#,#,#,#,#,#,#,#,#,#,#,#,#,#,#
