#,#,#,#,#,#,#,#,#,#,#,#,#,#,#,#
#,.,.,.,.,.,.,.,.,#,#,#,#,#,#,#
#,.,P,.,.,S,K,.,.,.,.,.,.,.,G,#
#,.,.,.,.,.,.,.,.,#,#,#,#,#,#,#
#,.,.,.,.,S,#,#,#,#,.,.,.,.,.,#
#,#,.,.,.,S,K,.,L,#,.,.,L,.,.,#
#,#,#,S,#,#,#,#,#,#,#,.,.,.,.,#
#,.,.,.,.,L,.,.,.,#,.,.,.,.,.,#
#,.,.,.,.,.,.,.,.,#,.,.,.,.,.,#
#,#,#,#,#,#,#,#,#,#,#,#,#,#,#,#
