#,#,#,#,#,#,#,#,#,#,#,#,#,#,#,#
#,L,.,.,#,.,.,.,.,.,.,.,.,G,.,#
#,L,.,.,#,#,.,.,.,.,.,.,.,.,.,#
#,L,.,.,.,.,.,.,.,.,.,.,#,#,#,#
#,L,.,.,#,#,.,.,.,.,S,.,.,.,.,#
#,L,.,.,#,.,.,.,.,.,.,.,#,#,.,#
#,L,.,.,#,.,S,.,.,.,.,.,.,#,.,#
#,L,.,.,#,.,.,.,.,.,.,.,.,#,.,#
#,L,.,.,#,.,P,.,.,.,.,.,.,#,.,#
#,L,.,.,#,.,.,.,.,.,.,.,.,#,L,#
#,#,#,#,#,#,#,#,#,#,#,#,#,#,#,#
