#,#,#,#,#,#,#,#,#,#,#,#,#,#,#,#
#,.,.,.,.,.,.,.,.,.,.,.,L,.,.,#
#,.,.,.,.,.,.,.,#,#,#,#,#,#,#,#
#,.,.,.,.,.,.,.,.,.,.,.,.,#,G,#
#,.,.,.,.,.,.,.,.,.,.,.,.,.,.,#
#,.,.,.,.,.,S,.,.,.,.,.,.,.,.,#
#,.,.,.,#,#,A,#,#,.,.,.,.,.,.,#
#,.,P,.,#,.,A,.,#,.,.,.,.,.,.,#
#,.,.,.,#,.,.,.,#,.,.,.,.,.,.,#
#,#,#,#,#,#,#,#,#,#,#,#,#,#,#,#
