#,#,#,#,#,#,#,#,#,#,#,#,#,#,#,#
#,.,.,.,.,L,A,.,.,.,.,.,#,A,#,#
#,.,G,.,P,.,.,.,.,.,S,.,#,15,#,#
#,.,.,.,#,.,.,.,.,.,.,.,.,.,.,#
#,.,#,#,#,#,H,.,.,.,.,.,.,.,.,#
#,.,34,L,28,.,.,.,28,.,.,.,.,.,.,#
#,.,#,#,#,#,H,.,.,.,.,.,.,.,.,#
#,.,.,.,#,.,.,.,.,.,.,.,.,.,.,#
#,.,.,.,34,.,.,.,.,.,S,.,.,.,.,#
#,.,.,.,#,.,.,.,.,.,.,.,.,.,.,#
#,#,#,#,#,#,#,#,#,#,#,#,#,#,#,#
