#,#,#,#,#,#,#,#,#,#,#,#,#,#,#,#
#,.,.,.,.,.,.,.,.,.,.,.,.,.,.,#
#,.,#,#,#,#,#,.,.,#,#,#,#,#,.,#
#,.,.,.,.,L,S,.,.,S,L,.,.,.,.,#
#,#,S,#,#,#,#,.,.,#,#,#,#,S,#,#
#,.,.,#,#,#,#,.,.,#,#,#,#,.,.,#
#,K,.,#,.,.,#,P,.,#,.,.,#,.,G,#
#,#,#,#,.,S,.,.,.,.,S,.,#,#,#,#
#,.,.,#,.,.,.,.,.,.,.,.,#,.,.,#
#,A,.,#,.,.,.,.,.,.,.,.,#,A,.,#
#,#,#,#,#,#,#,#,#,#,#,#,#,#,#,#
