#,#,#,#,#,#,#,#,#,#,#,#,#,#,#,#
#,.,.,.,.,.,.,.,.,.,.,.,.,#,#,#
#,.,#,S,#,#,#,#,#,#,#,.,.,.,.,#
#,.,#,.,.,#,.,.,.,.,#,.,.,.,.,#
#,.,#,.,.,#,.,P,.,.,#,.,.,.,.,#
#,.,#,G,.,#,.,.,.,.,#,.,.,.,.,#
#,.,#,#,#,#,.,S,.,.,#,#,#,S,#,#
#,.,#,L,.,#,.,.,.,.,.,.,.,.,.,#
#,.,#,#,.,#,#,#,#,#,#,#,#,#,.,#
#,.,.,.,.,.,.,.,.,.,.,.,.,#,L,#
#,#,#,#,#,#,#,#,#,#,#,#,#,#,#,#
