#,#,#,#,#,#,#,#,#,#,#,#,#,#,#,#
#,A,.,#,.,.,.,.,.,.,.,.,.,.,.,#
#,.,.,#,.,.,.,.,S,.,.,.,.,K,.,#
#,#,#,#,.,.,.,.,.,.,.,.,.,.,.,#
#,.,.,.,.,.,#,#,#,#,#,.,.,.,.,#
#,.,G,.,P,.,30,L,#,L,14,.,.,#,#,#
#,.,.,.,.,.,#,#,#,#,#,.,.,#,#,#
#,#,#,#,.,.,.,.,.,.,.,.,.,#,#,#
#,.,.,#,.,.,.,.,S,.,.,.,.,K,.,#
#,A,.,#,.,.,.,.,.,.,.,.,.,.,.,#
#,#,#,#,#,#,#,#,#,#,#,#,#,#,#,#
