#,#,#,#,#,#,#,#,#,#,#,#,#,#,#,#
#,#,#,#,.,.,.,.,.,#,#,#,#,#,#,#
#,#,G,#,.,.,.,.,.,.,.,.,.,.,.,#
#,#,20,#,.,.,.,.,.,#,#,#,#,#,#,#
#,.,.,.,.,.,.,.,.,#,.,.,.,.,.,#
#,#,.,#,.,#,#,#,.,#,.,.,L,.,.,#
#,#,P,S,.,.,L,#,.,#,.,.,.,.,.,#
#,#,#,#,#,#,#,#,.,#,.,.,.,.,.,#
#,.,.,.,.,.,.,.,.,#,.,.,.,.,.,#
#,#,#,#,#,#,#,#,#,#,#,#,#,#,#,#
