#,#,#,#,#,#,#,#,#,#,#,#,#,#,#,#
#,.,.,.,#,.,.,.,.,.,.,.,#,A,#,#
#,.,G,.,#,.,.,.,.,.,S,.,#,15,#,#
#,.,.,.,#,.,.,.,.,.,.,.,.,.,.,#
#,.,#,#,#,#,H,.,.,.,.,.,.,.,.,#
#,.,34,L,28,.,.,.,28,.,.,P,.,.,.,#
#,.,#,#,#,#,H,.,.,.,.,.,.,.,.,#
#,.,.,.,#,.,.,.,.,.,.,.,.,.,.,#
#,.,.,.,34,.,.,.,.,.,S,.,.,.,.,#
#,.,.,.,#,.,.,.,.,.,.,.,.,.,.,#
#,#,#,#,#,#,#,#,#,#,#,#,#,#,#,#
