#,#,#,#,#,#,#,#,#,#,#,#,#,#,#,#
#,.,.,.,.,.,.,G,.,.,.,.,.,#,#,#
#,.,K,.,.,.,.,.,.,.,.,.,.,.,#,#
#,.,.,.,.,.,.,.,.,.,.,.,.,.,.,#
#,.,.,.,.,.,.,S,.,.,.,.,.,.,.,#
#,.,P,.,.,.,S,A,S,.,.,.,.,.,L,#
#,.,.,.,.,.,.,S,.,.,.,.,.,.,.,#
#,.,.,.,.,.,.,.,.,.,.,.,.,.,.,#
#,.,K,.,.,.,.,.,.,.,.,.,.,.,#,#
#,.,.,.,.,.,.,.,.,.,.,.,.,#,#,#
#,#,#,#,#,#,#,#,#,#,#,#,#,#,#,#
