#,#,#,#,#,#,#,#,#,#,#,#,#,#,#,#
#,.,#,L,L,L,L,L,L,L,L,L,L,#,.,#
#,.,#,L,L,L,L,K,K,L,L,L,L,#,.,#
#,.,#,L,L,S,S,S,S,S,S,L,L,#,.,#
#,.,#,L,L,S,.,.,.,.,S,L,L,#,.,#
#,A,#,L,K,S,.,P,G,.,S,K,L,#,A,#
#,.,#,L,L,S,.,.,.,.,S,L,L,#,.,#
#,.,#,L,L,S,S,S,S,S,S,L,L,#,.,#
#,.,#,L,L,L,L,K,K,L,L,L,L,#,.,#
#,.,#,L,L,L,L,L,L,L,L,L,L,#,.,#
#,#,#,#,#,#,#,#,#,#,#,#,#,#,#,#