#,#,#,#,#,#,#,#,#,#,#,#,#,#,#,#
#,L,.,.,.,.,.,.,.,.,.,.,.,#,A,#
#,#,#,#,#,#,#,#,.,P,.,.,.,#,#,#
#,L,#,.,.,.,.,.,.,S,.,.,.,.,#,#
#,.,#,.,.,.,.,.,.,.,.,.,.,.,#,#
#,.,#,.,K,.,.,.,.,S,.,G,.,.,#,#
#,.,#,.,.,.,.,.,.,.,.,.,.,.,#,#
#,.,#,.,.,.,.,.,.,.,.,.,.,.,#,#
#,.,#,#,#,#,#,#,#,.,.,.,.,#,#,#
#,.,.,.,.,.,.,.,.,.,.,.,.,#,A,#
#,#,#,#,#,#,#,#,#,#,#,#,#,#,#,#
