#,#,#,#,#,#,#,#,#,#,#,#,#,#,#,#
#,.,.,.,.,.,.,.,.,.,.,.,.,.,.,#
#,.,#,#,#,#,#,.,.,#,#,#,#,#,.,#
#,.,.,.,.,L,S,.,.,S,L,.,.,.,.,#
#,#,S,#,#,#,#,.,.,#,#,#,#,S,#,#
#,.,.,#,#,#,#,.,.,.,.,.,#,.,.,#
#,K,.,#,#,#,#,P,.,S,.,.,#,.,G,#
#,#,#,#,#,.,S,.,.,.,.,.,#,#,#,#
#,.,.,#,#,.,.,.,.,.,.,.,#,.,.,#
#,A,.,#,#,.,.,.,.,.,.,.,#,A,.,#
#,#,#,#,#,#,#,#,#,#,#,#,#,#,#,#
